1.770  8.19457180107193E+0000  1.77000034094146E+0000  2.10288251494828E+0001
1.784  8.21599845918592E+0000  1.78400075161506E+0000  8.11094435830916E+0000
1.770  8.22999980000000E+0000  3.22999978009613E+0000  1.78041158626544E+0001
1.784  5.04511551855016E+0000  1.78400023302092E+0000  1.71744203658162E+0001
1.770  8.22999980000000E+0000  3.22999980000000E+0000  1.77000025807398E+0000
1.784  6.97697405707503E+0000  1.78400026948615E+0000  4.76498454492871E+0000
1.770  5.00509616576888E+0000  1.77000020000000E+0000  1.77000020000000E+0000
1.784  5.06338829718869E+0000  1.78400021005042E+0000  1.06415080395544E+0001
1.770  8.22999980000000E+0000  3.22999977839136E+0000  1.13574519057864E+0001
1.784  4.95332695298588E+0000  3.21599969169047E+0000  1.39076819037578E+0001
1.770  1.88907770907365E+0000  3.22999980000000E+0000  1.13225047103562E+0001
1.784  1.78400020000000E+0000  1.78400020000000E+0000  8.07766841211219E+0000
1.770  8.12932260328599E+0000  1.77000028848971E+0000  1.45807838850075E+0001
1.784  1.78400030120314E+0000  1.78400020000000E+0000  2.10148252193565E+0001
1.770  1.85349500631675E+0000  3.22999980000000E+0000  1.77690318844611E+0001
1.784  5.00888301333766E+0000  3.21599977906244E+0000  7.37393499604719E+0000
1.770  1.77000020417527E+0000  3.22999980000000E+0000  1.77000020000000E+0000
1.784  3.06441730525159E+0000  1.78400020030120E+0000  4.74732925981148E+0000
1.770  1.77000022219046E+0000  1.77000020000000E+0000  1.45452092313643E+0001
1.784  5.00146939698812E+0000  3.21599543187750E+0000  2.04421766584602E+0001
 2.27988254193565E+0001