2.411  2.41100020000000E+0000  2.41100020000000E+0000  3.43815061986625E+0001
1.740  5.11477450003425E+0000  3.25999980000000E+0000  1.98987565081259E+0001
1.926  8.06231084281834E+0000  3.02874570814302E+0000  2.68692139303282E+0001
1.292  5.18052427658882E+0000  3.69569417898041E+0000  3.64947090401094E+0001
2.238  2.23800020000000E+0000  2.23800020000000E+0000  2.24490846280602E+0001
1.277  3.84758547599894E+0000  3.72299980000000E+0000  2.71378345115846E+0001
1.342  8.65741131052882E+0000  3.65795488227938E+0000  1.65720747558427E+0001
2.003  2.00300021101489E+0000  2.99699964625077E+0000  1.78353263018948E+0001
1.906  5.52553675834041E+0000  1.90600020000000E+0000  1.65385067680565E+0001
1.646  4.77181906087026E+0000  1.64600020332891E+0000  4.68874441656967E+0001
2.331  2.33100022126868E+0000  2.64462458910563E+0000  4.98643024143617E+0001
1.628  8.37199980000000E+0000  1.62800020000000E+0000  1.14865125402505E+0001
1.978  2.00618716290054E+0000  2.94742032506531E+0000  2.99820710306528E+0001
2.439  2.43900020000000E+0000  2.56099978359768E+0000  2.43900020000000E+0000
2.230  7.76999980000000E+0000  2.23000025762277E+0000  3.45463017480008E+0001
2.259  2.26530862843614E+0000  2.28100732652209E+0000  1.35813939461538E+0001
1.534  8.42502908534415E+0000  1.53407071365561E+0000  1.46467638545852E+0001
1.841  1.84100020000000E+0000  3.15899976402970E+0000  9.31199910788033E+0000
1.747  8.25213647854887E+0000  1.74707655803591E+0000  1.89651123736390E+0001
2.441  7.53788629405129E+0000  2.55899980000000E+0000  4.97543024163868E+0001
1.716  4.99370584124605E+0000  1.71600020000000E+0000  2.52361478858767E+0001
2.167  5.04776494302712E+0000  2.83299980000000E+0000  4.32744318619612E+0001
1.837  8.16299980000000E+0000  1.83700020000000E+0000  4.55842620064896E+0001
1.451  8.54899978343414E+0000  1.45100026620060E+0000  5.70393219032041E+0000
1.783  5.04847238941451E+0000  1.78300020000000E+0000  1.02877686655187E+0001
1.450  1.45000027521812E+0000  3.54999964241084E+0000  6.06778548802890E+0000
1.567  1.56700020000000E+0000  1.56700020000000E+0000  4.28008491208636E+0001
1.779  8.22099980000000E+0000  1.77900020000000E+0000  3.05883626166143E+0001
2.465  7.46578295391408E+0000  2.46500020000000E+0000  3.92255384276183E+0001
1.671  5.34450600833008E+0000  3.32899980000000E+0000  3.16955152279262E+0001
1.690  5.27297837205234E+0000  1.69000020000000E+0000  2.87621063456107E+0001
1.705  6.08992466851621E+0000  3.29499980000000E+0000  1.32534694428314E+0001
2.347  7.24094257000144E+0000  2.65299952334039E+0000  2.34700025423817E+0000
1.732  1.73200020000000E+0000  1.73200020000000E+0000  2.63540598142965E+0001
1.444  8.55599980000000E+0000  3.55599980000000E+0000  4.28173946550056E+0001
2.374  2.62995216130430E+0000  2.62599980000000E+0000  3.91566568826931E+0001
1.824  1.82400041158024E+0000  3.17599980000000E+0000  4.57747278713642E+0001
2.197  7.80299980000000E+0000  2.80299980000000E+0000  2.27385747889680E+0001
1.780  8.21999980000000E+0000  3.21999980000000E+0000  8.47704416111941E+0000
2.220  5.01078954219306E+0000  2.22000020000000E+0000  6.30887142883899E+0000
 5.21953026163868E+0001