2.265  7.73499980000000E+0000  2.73499980000000E+0000  3.24679886771718E+0001
1.880  8.11999980000000E+0000  1.88000020000000E+0000  2.75245772477720E+0001
1.554  8.44599980000000E+0000  3.44599980000000E+0000  3.66353822116964E+0001
2.265  2.26500020000000E+0000  2.73499980000000E+0000  1.04116312036422E+0001
1.880  8.11999977956575E+0000  1.88000020230099E+0000  6.14994897306141E+0000
1.554  4.96399469249995E+0000  1.57785478635430E+0000  2.24126419700514E+0001
2.265  6.95502039551698E+0000  2.73499980000000E+0000  2.26500020000000E+0000
1.880  8.11999980000000E+0000  1.88000020000000E+0000  2.37645768390303E+0001
1.554  5.06052227366488E+0000  3.44599980000000E+0000  7.55568720955599E+0000
2.265  7.73499980000000E+0000  2.73499980000000E+0000  1.97270306806103E+0001
1.880  1.88000020000000E+0000  3.11999980000000E+0000  3.43181814382542E+0001
1.554  8.34428624037628E+0000  1.55400023971422E+0000  3.90990499297986E+0001
2.265  2.26500021229896E+0000  2.26500021422658E+0000  2.26500020000000E+0000
1.880  1.88000020000000E+0000  3.11999980000000E+0000  6.30254634544768E+0000
1.554  1.64105289244846E+0000  3.39207356285588E+0000  3.08627369038538E+0001
2.265  2.26500020000000E+0000  2.73499980000000E+0000  1.49572629092926E+0001
1.880  5.06063195528493E+0000  3.11999980000000E+0000  2.55646524806192E+0001
1.554  5.87851797163007E+0000  3.44599881235602E+0000  3.90990445350633E+0001
2.265  7.73499980000000E+0000  2.73499980000000E+0000  1.01874951410225E+0001
1.880  1.88000020000000E+0000  1.88000020000000E+0000  2.77487133266172E+0001
1.554  4.70481149516103E+0000  1.55400020000000E+0000  5.11571307892236E+0000
2.265  7.73499980000000E+0000  2.73499980000000E+0000  1.51813989874516E+0001
1.880  5.49305989692638E+0000  1.88000020000000E+0000  3.58478865188481E+0001
1.554  4.90227813567457E+0000  1.55400020000000E+0000  1.74542148326356E+0001
2.265  2.26500020000000E+0000  2.73499980000000E+0000  1.99511667612319E+0001
1.880  1.88000020000000E+0000  1.88000020000000E+0000  2.39887129197649E+0001
1.554  5.09772184898174E+0000  1.55400020000000E+0000  1.26844470639588E+0001
2.265  2.26500020000000E+0000  2.43518344924889E+0000  3.83880499713242E+0001
1.880  5.06063195178327E+0000  3.11999980000000E+0000  2.93246528849216E+0001
1.554  4.11103269075506E+0000  1.55400020000000E+0000  3.22295220959154E+0001
 4.06530501713242E+0001