1.554  3.74562770163359E+0000  1.55400020000000E+0000  5.97987762421260E+0000
1.468  3.94506829920752E+0000  3.53199980000000E+0000  8.25588889125340E+0000
1.314  8.68599956134970E+0000  3.68599973214369E+0000  2.13461523160801E+0001
1.488  3.85402034595123E+0000  1.48800020000000E+0000  1.48800020000000E+0000
1.401  8.55289496863128E+0000  3.59862846564746E+0000  1.10170575927213E+0001
1.479  6.01502090761602E+0000  3.52099979945942E+0000  1.47900020000000E+0000
1.662  3.54831140815497E+0000  3.33799980000000E+0000  1.78491052868091E+0001
1.610  6.16121207721334E+0000  1.61000020000000E+0000  1.10579494784468E+0001
1.500  1.52425518091164E+0000  1.50000020390112E+0000  3.87943243649997E+0000
1.494  6.34103746619384E+0000  3.50599950398708E+0000  2.30413123783680E+0001
1.645  1.64521738810486E+0000  1.68199885856569E+0000  1.56894926059490E+0001
1.267  8.73299980000000E+0000  1.26700020000000E+0000  2.03250350083443E+0001
1.305  3.42797736280607E+0000  1.30500020000000E+0000  9.82516285305212E+0000
1.322  6.67635459405874E+0000  3.67425436226579E+0000  9.03782654207628E+0000
1.292  4.54519677685263E+0000  1.29216313762236E+0000  1.59451790846146E+0001
1.395  8.23524362590266E+0000  1.39500020000000E+0000  6.15304961854654E+0000
1.392  3.92213711180410E+0000  3.60799980000000E+0000  1.11388637084520E+0001
1.296  6.36778168279434E+0000  1.29600020459249E+0000  2.13118851209749E+0001
1.342  5.72192332503023E+0000  1.34537046875567E+0000  8.13722355429770E+0000
1.626  1.62600020000000E+0000  1.62908386096028E+0000  2.29093135107720E+0001
1.458  3.90812786714673E+0000  1.46118698039508E+0000  1.31457532315217E+0001
1.482  6.02876245406128E+0000  1.48200020585015E+0000  1.83973428764786E+0001
1.583  1.58300020000000E+0000  3.41699977620996E+0000  1.29671374318987E+0001
1.535  6.16312447614191E+0000  3.46499980000000E+0000  6.23258732423628E+0000
1.284  8.71599979563026E+0000  3.71599980000000E+0000  7.40159970105753E+0000
1.533  8.46699980000000E+0000  3.46699980000000E+0000  4.09725465517759E+0000
1.252  1.25200020000000E+0000  1.25200020000000E+0000  1.11670143455337E+0001
1.587  8.41299980000000E+0000  3.41299980000000E+0000  1.84709573840172E+0001
1.334  3.77155801461517E+0000  3.66599980000000E+0000  1.48794932941086E+0001
1.316  4.55275979652669E+0000  1.32757714674337E+0000  2.32116864877290E+0001
1.408  1.40800097631669E+0000  1.40800020069440E+0000  7.97038966210259E+0000
1.485  3.71541302307863E+0000  3.51499980000000E+0000  3.65843606305235E+0000
1.545  1.54500025382756E+0000  3.45499979328311E+0000  1.54500020741880E+0000
1.559  6.04359706551073E+0000  1.55900020000000E+0000  3.79830772055826E+0000
1.480  8.51999979190815E+0000  1.48199190492932E+0000  2.30553135176771E+0001
1.307  3.63329371809462E+0000  3.69299967238572E+0000  2.23493878852447E+0001
1.466  1.46600027065019E+0000  3.53399979188093E+0000  6.03735054216768E+0000
1.362  6.53378566751736E+0000  1.36221138468278E+0000  1.41826379337190E+0001
1.538  3.66570933200718E+0000  1.53800020000000E+0000  2.04922514562563E+0001
1.451  1.45234186526435E+0000  3.54823094330898E+0000  2.05073377861202E+0001
1.379  1.37900023406920E+0000  1.37900026231508E+0000  1.86882080776915E+0001
1.594  8.40599969862851E+0000  1.59400020000000E+0000  1.59400020000000E+0000
1.530  6.32883975602373E+0000  3.46921248960460E+0000  1.61538884983290E+0001
1.312  5.79867320380497E+0000  3.68760797704291E+0000  1.30851589211881E+0001
1.269  8.73099980000000E+0000  1.26900020000000E+0000  1.23103683188166E+0001
1.489  8.51099979625180E+0000  1.48900020000000E+0000  9.04110536501899E+0000
1.520  8.47999980000000E+0000  3.47999980000000E+0000  1.39917376598374E+0001
1.431  1.43100020370935E+0000  3.56899976286605E+0000  9.81144243503467E+0000
1.437  8.54599342933419E+0000  1.44584907125357E+0000  1.61627914276038E+0001
1.369  5.66673387570242E+0000  3.63099980000000E+0000  2.02355320330206E+0001
 2.45353137176771E+0001
