1.426  4.04021693616806E+0000  3.57399978862700E+0000  2.14899614312749E+0001
1.536  8.46399980000000E+0000  1.53600020000000E+0000  1.33234678701551E+0001
1.277  3.79140162323309E+0000  3.72299980000000E+0000  1.47081779275634E+0001
1.304  2.52492584015804E+0000  1.30436996418323E+0000  2.13913656607839E+0001
1.622  8.37799980000000E+0000  1.62200020000000E+0000  2.34812268146595E+0001
1.480  1.48478606536192E+0000  3.51894407049188E+0000  4.53395939739985E+0000
1.302  2.85068009887082E+0000  3.69799975684953E+0000  1.80663534757332E+0001
1.663  1.66327902331351E+0000  3.27225991432581E+0000  2.34399476607934E+0001
1.519  5.91234160910430E+0000  3.46671160356031E+0000  8.73598557578543E+0000
1.475  4.24102235120498E+0000  1.56225607532074E+0000  1.91696571152890E+0001
1.540  6.08370790259483E+0000  3.45999979884822E+0000  1.30165246010591E+0001
1.279  8.72099917515462E+0000  1.27900027700891E+0000  5.06492386713827E+0000
1.446  6.22018678040952E+0000  3.55399980000000E+0000  1.44600057723497E+0000
1.360  8.63999980000000E+0000  3.63999980000000E+0000  1.89567534860159E+0001
1.337  1.69291762586840E+0000  3.66299980000000E+0000  1.31506915879420E+0001
1.462  6.00986493497204E+0000  1.46200020000000E+0000  2.15121165163384E+0001
1.639  8.36099980000000E+0000  3.36099980000000E+0000  1.07274333846197E+0001
1.322  6.02740024974089E+0000  3.67799946089640E+0000  1.95947588443886E+0001
1.417  6.06899833405633E+0000  1.41700020000000E+0000  1.51542307825815E+0001
1.373  4.07260516669700E+0000  1.39211100315387E+0000  2.36894997793572E+0001
1.559  6.22070015827233E+0000  1.56355218115205E+0000  3.74391101024269E+0000
1.506  3.33982843594769E+0000  1.50600020000000E+0000  1.63286980826562E+0001
1.441  6.81792199688452E+0000  3.55899980000000E+0000  5.91942571685714E+0000
1.459  3.69643169472885E+0000  1.45900020000000E+0000  8.72681333627059E+0000
1.420  1.42000020000000E+0000  1.42000020000000E+0000  1.85351300192305E+0001
1.426  5.96656991965120E+0000  1.42640055668773E+0000  1.08598144791098E+0001
1.536  3.80621964246538E+0000  3.46399980000000E+0000  1.09489632941280E+0001
1.277  5.64032915142708E+0000  1.27700020000000E+0000  6.81008777296263E+0000
1.304  4.30436881857124E+0000  3.69425137980270E+0000  3.63850740161387E+0000
1.622  3.84341826929609E+0000  1.62200026447643E+0000  1.62200020000000E+0000
1.480  1.49570263236522E+0000  1.48181879809359E+0000  6.68502719017758E+0000
1.302  7.83759533328344E+0000  3.69799980000000E+0000  2.14942777031146E+0001
1.663  8.33699938690832E+0000  3.33699980000000E+0000  1.59642773845548E+0001
1.519  1.51900020000000E+0000  3.48099980000000E+0000  8.92378036489582E+0000
1.475  7.00322866148544E+0000  1.47500020672145E+0000  1.81376172413354E+0001
1.540  8.42272354048784E+0000  1.54000020000000E+0000  1.54000020000000E+0000
1.279  1.27900020752307E+0000  1.27900020941217E+0000  2.93421787875630E+0000
1.446  1.46664955357999E+0000  3.55399980000000E+0000  1.44600022059629E+0000
1.360  8.63587890760788E+0000  1.36524083425579E+0000  2.04670345588147E+0001
1.337  3.35394891201610E+0000  1.33700020000000E+0000  4.52628636379011E+0000
1.462  5.96669237217438E+0000  3.53799980000000E+0000  2.36412268106593E+0001
1.639  8.36099950996882E+0000  1.63900038494577E+0000  7.93816722713983E+0000
1.322  1.32200027464352E+0000  1.32200023951847E+0000  1.43558574273141E+0001
1.417  8.58299980000000E+0000  3.58299980000000E+0000  3.67174016220696E+0000
1.373  1.37300033071039E+0000  3.57083679410751E+0000  1.58401639709428E+0001
1.559  3.84191991466276E+0000  3.44099980000000E+0000  6.45550597023871E+0000
1.506  1.50600020000000E+0000  1.50600020000000E+0000  1.13081211173191E+0001
1.441  5.37198677368279E+0000  3.55899980000000E+0000  1.69132586083668E+0001
1.459  3.85538301661201E+0000  1.45900020000000E+0000  1.31732804441896E+0001
1.420  1.42000020000000E+0000  3.57999980000000E+0000  2.03790399681336E+0001
 2.51032270146595E+0001
