2.411  7.53193925078801E+0000  7.54029208442063E+0000  2.42770742747951E+0000
1.740  5.25303108393931E+0000  8.25999973356020E+0000  1.37511274482665E+0001
1.926  1.93927027668980E+0000  8.07399980000000E+0000  1.15915278934443E+0001
1.292  8.70799974148126E+0000  4.99813754312108E+0000  5.05237314250282E+0000
2.238  2.23800035284128E+0000  2.23800037193312E+0000  1.95650057076626E+0001
1.277  5.02316402389941E+0000  1.27700026651636E+0000  4.82160831613064E+0000
1.342  4.94693303352136E+0000  8.65799975818283E+0000  5.04722339482239E+0000
2.003  5.00506801530439E+0000  5.05435976932944E+0000  1.18347663027447E+0001
1.906  8.09399978346919E+0000  1.90600041348039E+0000  1.54809711682106E+0001
1.646  1.64600020000000E+0000  4.77917067757435E+0000  1.02434625907796E+0001
2.331  2.57045133969706E+0000  2.33100020000000E+0000  7.24873664490767E+0000
1.628  5.02806761734008E+0000  4.84364509010873E+0000  2.01750057102674E+0001
1.978  1.97800020000000E+0000  8.02199980000000E+0000  1.54949898376700E+0001
2.439  2.43900020931972E+0000  7.56099978472144E+0000  2.43900020802886E+0000
2.230  7.47746439785835E+0000  7.76293162215332E+0000  1.95730053896982E+0001
2.259  7.74099980000000E+0000  7.72091756283318E+0000  7.11658841184545E+0000
1.534  5.02734904702853E+0000  1.53451074244937E+0000  1.71212607347403E+0001
1.841  5.03706426514432E+0000  5.12001790050817E+0000  5.01666945238582E+0000
1.747  8.23958473474284E+0000  5.17497353939238E+0000  1.37542821404249E+0001
2.441  7.55899963725568E+0000  2.59068600103383E+0000  2.44100022581881E+0000
1.716  4.89640635603705E+0000  1.71600045093025E+0000  1.37903549159335E+0001
2.167  4.83509484364228E+0000  5.05764937634017E+0000  1.60023841145623E+0001
1.837  8.16299980000000E+0000  2.04985516976206E+0000  1.17413726673677E+0001
1.451  1.46421140487350E+0000  5.12889522404216E+0000  1.73616216226121E+0001
1.783  8.21699966693185E+0000  8.21699585567929E+0000  1.56549588863230E+0001
1.450  5.05008315999341E+0000  8.54998170575566E+0000  1.69214396653208E+0001
1.567  8.42259249130720E+0000  5.02703079848095E+0000  1.70887232289113E+0001
1.779  1.82833919167045E+0000  1.77900020000000E+0000  1.18855214408748E+0001
2.465  2.46500030193841E+0000  2.65713719285496E+0000  2.46500020000000E+0000
1.671  4.94215067174558E+0000  1.67100020958238E+0000  1.04039624007190E+0001
1.690  5.22681161613542E+0000  8.30999974584459E+0000  1.01043039403965E+0001
1.705  8.29499949285463E+0000  5.19796737511037E+0000  1.01234317031384E+0001
2.347  2.34700034849914E+0000  7.47308288029064E+0000  7.38068582870522E+0000
1.732  1.73200023088752E+0000  4.83014481560557E+0000  1.36199836279768E+0001
1.444  5.26801482482654E+0000  5.28469384100942E+0000  8.40553554310738E+0000
2.374  7.47587801053089E+0000  2.37400048012976E+0000  7.29633022986437E+0000
1.824  1.82400020180841E+0000  1.82400107804829E+0000  1.55454216498334E+0001
2.197  2.67241760432996E+0000  7.80299978290309E+0000  1.96060057440943E+0001
1.780  8.21999980000000E+0000  8.21999968764818E+0000  1.18574803118994E+0001
2.220  7.77999978637121E+0000  2.22000020000000E+0000  1.95830057300065E+0001
 2.18030059440943E+0001