1.890  5.07555429463587E+0000  1.89000020000000E+0000  3.19136489851568E+0001
1.512  4.84600316923584E+0000  3.48799980000000E+0000  5.32066534202833E+0000
2.419  2.50657815565546E+0000  2.41900020000000E+0000  3.77505272019609E+0001
1.850  4.87952518928616E+0000  1.85000073921948E+0000  1.59895956764814E+0001
1.943  4.84783103562825E+0000  1.97650740949770E+0000  4.14440588476369E+0001
1.890  1.89000020000000E+0000  3.10999980000000E+0000  3.35422216518476E+0001
1.512  4.82873499809037E+0000  1.54265541178912E+0000  4.81070665642191E+0001
2.419  2.41900020000000E+0000  2.41900021834824E+0000  2.41900020000000E+0000
1.850  5.08283530663672E+0000  1.85000033104898E+0000  1.98868574009147E+0001
1.943  1.94301417004978E+0000  1.94303342440173E+0000  6.72877304856706E+0000
1.890  8.10999980000000E+0000  3.10999977714825E+0000  5.67939365437225E+0001
1.512  5.14218598136618E+0000  1.58898824024828E+0000  5.79836192662770E+0001
2.419  7.33808151159840E+0000  2.58099978544600E+0000  2.41900020000000E+0000
1.850  1.85000020748408E+0000  3.14999980000000E+0000  4.92317588003855E+0001
1.943  1.95472576644033E+0000  1.98570349461605E+0000  6.54951908166330E+0001
1.890  1.89000020000000E+0000  1.89000020000000E+0000  5.66586549111578E+0001
1.512  4.83995094573886E+0000  3.45553619306280E+0000  2.88677378466705E+0001
2.419  7.27839445071920E+0000  2.41900021016847E+0000  4.50805624273183E+0001
1.850  1.85000020000000E+0000  1.85000025186785E+0000  3.00210835954173E+0001
1.943  8.05699980000000E+0000  1.94300020000000E+0000  6.67378106648390E+0000
1.890  8.10999979366312E+0000  3.10999980000000E+0000  2.16858246381225E+0001
1.512  4.84752721894430E+0000  3.46208321847945E+0000  2.28549294744862E+0001
2.419  7.35313635783174E+0000  2.41900020000000E+0000  3.78876977575731E+0001
1.850  1.85000020000000E+0000  3.14999946744700E+0000  1.43022673952287E+0001
1.943  1.94300020000000E+0000  1.94300020000000E+0000  1.06656102081206E+0001
1.890  8.10999980000000E+0000  3.10999980000000E+0000  3.00183536703738E+0001
1.512  8.48799979866032E+0000  3.48799980000000E+0000  4.14963109150776E+0001
2.419  2.41900020000000E+0000  2.58099980000000E+0000  6.08788637932329E+0001
1.850  4.91324876508790E+0000  3.14999980000000E+0000  5.48531156405726E+0001
1.943  8.05699980000000E+0000  1.94300026386700E+0000  6.53262528836442E+0001
1.890  8.10707851433691E+0000  1.89361276864664E+0000  1.05107341061645E+0001
1.512  5.01201435818535E+0000  3.48799980000000E+0000  3.49163088988448E+0001
2.419  2.44041179390654E+0000  2.41900020000000E+0000  4.50674559620265E+0001
1.850  5.08675120342439E+0000  3.14999980000000E+0000  5.10808693233630E+0001
1.943  1.94300020000000E+0000  1.94300020000000E+0000  5.28263874226628E+0001
1.890  8.10999980000000E+0000  1.89000020000000E+0000  4.92753301203208E+0001
1.512  5.04257435986591E+0000  3.48799980000000E+0000  6.60068727557330E+0001
2.419  7.25428726267452E+0000  2.41900020000000E+0000  2.58520891566883E+0001
1.850  8.14999980000000E+0000  1.85000020000000E+0000  1.42592777744650E+0001
1.943  8.04867410371957E+0000  3.05699980000000E+0000  1.78536813422137E+0001
1.890  5.01797335598237E+0000  3.10999980000000E+0000  8.69722409790977E+0000
1.512  4.91508625335838E+0000  1.51200020000000E+0000  6.37213201735451E+0001
2.419  7.58099980000000E+0000  2.58099980000000E+0000  6.10374966740995E+0001
1.850  1.85000021719375E+0000  1.85000021161932E+0000  2.16865186548434E+0001
1.943  8.05699980000000E+0000  1.94300021982707E+0000  5.31075976374799E+0001
1.890  5.11355778407965E+0000  3.10999980000000E+0000  1.24760157948082E+0001
1.512  1.51200020000000E+0000  3.48799980000000E+0000  4.14002968666138E+0001
2.419  2.41900020000000E+0000  2.58099979180833E+0000  2.58538011235141E+0001
1.850  8.14999980000000E+0000  3.14999976162493E+0000  3.37579262491508E+0001
1.943  1.96267792259332E+0000  3.05699978257676E+0000  1.80924530028127E+0001
 6.75188729557330E+0001
