1.890  1.97273967385074E+0000  1.89000023403659E+0000  9.45669862881035E+0000
1.512  5.00977534754298E+0000  5.95984119363736E+0000  1.32915000948231E+0001
2.419  7.58099980000000E+0000  5.08099980000000E+0000  1.99720064382379E+0001
1.850  4.98066044155624E+0000  5.08291848387283E+0000  2.64492918498024E+0001
1.943  7.99927700992934E+0000  2.03454543668175E+0000  2.63356031963055E+0001
1.890  7.95657518034927E+0000  5.60162675888675E+0000  1.11159336963289E+0001
1.512  4.72724627243702E+0000  5.98799980000000E+0000  9.72680303631675E+0000
2.419  2.41900020000000E+0000  5.08099980000000E+0000  1.99181248151496E+0001
1.850  1.85000020000000E+0000  2.04400216471885E+0000  1.69724076992194E+0001
1.943  2.09951823649112E+0000  5.55699976901857E+0000  1.55640607025668E+0001
1.890  8.10999974893526E+0000  1.89000020221962E+0000  1.32135043667518E+0001
1.512  8.46825876590376E+0000  5.97907464119985E+0000  3.27928017078629E+0001
2.419  2.41900020000000E+0000  2.41900020000000E+0000  3.12551252312300E+0001
1.850  8.14999980000000E+0000  2.12403320018433E+0000  1.69459608709388E+0001
1.943  1.94300020000000E+0000  5.55699980000000E+0000  2.42278690767948E+0001
1.890  1.89000020093591E+0000  1.89000022046593E+0000  1.32357933974479E+0001
1.512  4.71803410837317E+0000  5.97590341852563E+0000  5.50838540858045E+0000
2.419  5.01843109993575E+0000  5.08099980000000E+0000  3.44767537147410E+0001
1.850  1.85000020000000E+0000  5.64999980000000E+0000  2.83380448905435E+0001
1.943  8.05699980000000E+0000  5.55699980000000E+0000  7.14733545869530E+0000
1.890  8.10999980000000E+0000  2.20408604053599E+0000  9.44657549426651E+0000
1.512  1.51447808964955E+0000  1.51404838558352E+0000  2.13070247968871E+0001
2.419  2.41900020000000E+0000  5.08099980000000E+0000  2.41900020000000E+0000
1.850  8.14999980000000E+0000  5.64999980000000E+0000  2.82723961333578E+0001
1.943  8.05699980000000E+0000  5.55699980000000E+0000  2.42817506973657E+0001
1.890  1.90164580263933E+0000  5.60627344501713E+0000  7.84972185411096E+0000
1.512  8.42854438456817E+0000  1.54174770395976E+0000  2.15515505747426E+0001
2.419  7.51924339198290E+0000  5.08099980000000E+0000  2.84486047786315E+0000
1.850  4.97977787898895E+0000  1.85000020000000E+0000  3.96649889944984E+0001
1.943  8.05699980000000E+0000  1.94300020000000E+0000  3.56634790149636E+0001
1.890  4.98477414199060E+0000  3.31747149377211E+0000  7.63501801439205E+0000
1.512  5.05220260759056E+0000  1.59749615540583E+0000  2.82776989862591E+0001
2.419  7.58099980000000E+0000  2.41900020000000E+0000  3.13537347598018E+0001
1.850  5.02022217304684E+0000  5.64999980000000E+0000  3.02458434916019E+0001
1.943  1.94300020137301E+0000  1.94300020000000E+0000  3.55648694878548E+0001
1.890  8.10999978202896E+0000  1.89000020000000E+0000  5.67964662269081E+0000
1.512  1.53473560000346E+0000  1.51935955509720E+0000  3.99850859954475E+0001
2.419  4.88921268393863E+0000  2.41900020000000E+0000  2.31146942685645E+0001
1.850  4.87659388996905E+0000  1.85000020000000E+0000  3.74007508246462E+0000
1.943  8.04770096177039E+0000  5.44922383154186E+0000  1.49637720964796E+0001
1.890  4.98024179796766E+0000  3.05583381982742E+0000  1.51932521405071E+0001
1.512  5.24724636523783E+0000  5.98203841267999E+0000  1.69343719835537E+0001
2.419  7.58099980000000E+0000  5.08099980000000E+0000  3.86557072197496E+0001
1.850  1.85000020000000E+0000  2.49563283330646E+0000  5.76810171037307E+0000
1.943  1.94300032257257E+0000  5.39469820354520E+0000  1.16846069621358E+0001
1.890  4.99350905842866E+0000  3.04547075618366E+0000  1.14132885958963E+0001
1.512  8.48799980000000E+0000  1.51200020000000E+0000  1.51200020000000E+0000
2.419  2.41900020000000E+0000  5.08099980000000E+0000  3.85570976949391E+0001
1.850  5.01105949866435E+0000  1.85000020000000E+0000  1.88855387022254E+0001
1.943  1.99788727053912E+0000  2.04054504856212E+0000  2.64962900841169E+0001
 4.15149891944984E+0001
