1.546  3.93629471705642E+0000  3.45399980000000E+0000  2.57007915737035E+0001
1.473  3.86348885035803E+0000  3.52632455387068E+0000  1.61272612695309E+0001
1.478  3.96354341570148E+0000  1.47800020000000E+0000  8.24415523298575E+0000
1.561  1.57545956755585E+0000  1.59337180272268E+0000  1.57465813541283E+0000
1.615  8.14396977668310E+0000  3.37259728159029E+0000  3.08488482854055E+0001
1.546  8.45399980000000E+0000  1.54600020000000E+0000  2.34103239765321E+0001
1.473  4.02080407273947E+0000  3.52699980000000E+0000  2.08197164615854E+0001
1.478  6.05992284082866E+0000  1.47800033489535E+0000  5.87086473204264E+0000
1.561  3.79634921936317E+0000  3.43899980000000E+0000  1.11956195108552E+0001
1.615  4.36748200459282E+0000  1.61500052547358E+0000  1.37489008830451E+0001
1.546  8.45399980000000E+0000  1.54600020000000E+0000  4.02469230272197E+0000
1.473  8.52699980000000E+0000  3.52699980000000E+0000  2.09877733891670E+0001
1.478  8.52199980000000E+0000  1.47800020000000E+0000  9.02606217012109E+0000
1.561  8.43899970225675E+0000  3.43899980000000E+0000  1.56100020000000E+0000
1.615  1.66563024887622E+0000  3.38499978952137E+0000  1.37470783443983E+0001
1.546  1.54600020000000E+0000  3.45399980000000E+0000  2.37221039325795E+0001
1.473  5.96099961302864E+0000  1.47300037268199E+0000  1.63901667483311E+0001
1.478  1.47800020000000E+0000  1.47800020000000E+0000  1.13191576148845E+0001
1.561  6.21229972634021E+0000  3.43899980000000E+0000  2.83050974036282E+0001
1.615  4.31685215958614E+0000  3.38499978843357E+0000  3.08529084419281E+0001
1.546  3.74864386051143E+0000  1.54600020000000E+0000  2.83251936241533E+0001
1.473  8.52283699507429E+0000  1.47444971937624E+0000  2.84378498849495E+0001
1.478  3.93781361353868E+0000  3.52199980000000E+0000  6.10889369225046E+0000
1.561  8.43899980000000E+0000  3.43899980000000E+0000  1.13462162331835E+0001
1.615  1.61500020000000E+0000  1.61500020000000E+0000  3.08529084451679E+0001
1.546  6.25062535981739E+0000  3.45399980000000E+0000  1.87857716619619E+0001
1.473  8.52699979280471E+0000  1.47300020000000E+0000  1.88759012711100E+0001
1.478  1.47800026227120E+0000  3.52199975038272E+0000  3.97076174105047E+0000
1.561  3.80133856426813E+0000  1.56100020000000E+0000  1.85193167466080E+0001
1.615  7.70472969412369E+0000  1.61500020000000E+0000  1.38403796602327E+0001
1.546  8.45399980000000E+0000  3.45399980000000E+0000  2.61538171078598E+0001
1.473  6.18608298659817E+0000  3.52699980000000E+0000  2.36260941392710E+0001
1.478  6.15040354099194E+0000  3.51137282316013E+0000  3.68022607614607E+0000
1.561  6.19287590544339E+0000  3.43899980000000E+0000  8.89229140583468E+0000
1.615  1.61500020000000E+0000  3.38499980000000E+0000  8.88785445008290E+0000
1.546  1.54600020000000E+0000  1.54600020000000E+0000  2.61552097364303E+0001
1.473  6.10718645423047E+0000  1.47300020000000E+0000  1.12015469482422E+0001
1.478  3.98342856219865E+0000  3.52199980000000E+0000  1.47800020000000E+0000
1.561  1.56100020577186E+0000  1.56100021699447E+0000  1.63449730234119E+0001
1.615  1.61500020000000E+0000  1.61500020000000E+0000  2.11232151544641E+0001
1.546  6.26173993777787E+0000  1.54600020000000E+0000  2.12298508883774E+0001
1.473  1.47300020087681E+0000  3.52699980000000E+0000  2.84321978395693E+0001
1.478  6.11884531812758E+0000  1.47800026044654E+0000  1.47800397540573E+0000
1.561  1.62306822905841E+0000  1.56100080750701E+0000  6.28786477993032E+0000
1.615  8.38499980000000E+0000  3.38499980000000E+0000  6.59475902386125E+0000
1.546  3.93629471907965E+0000  1.54600020000000E+0000  2.32676857731436E+0001
1.473  6.21415241333121E+0000  1.47300020000000E+0000  2.57377797057276E+0001
1.478  1.48065273907011E+0000  3.51978776033473E+0000  1.86801597485183E+0001
1.561  3.79273021774334E+0000  1.56100020000000E+0000  3.79179319823163E+0000
1.615  8.38499980000000E+0000  3.38499980000000E+0000  1.64551906314606E+0001
 3.24679086451679E+0001
