1.546  4.05638602845729E+0000  1.72735384143706E+0000  1.49428933517104E+0001
1.473  1.47300021842160E+0000  1.47300020192973E+0000  4.41900070277527E+0000
1.478  3.78605078363922E+0000  3.81530595992591E+0000  1.75311697129628E+0001
1.561  8.43899980000000E+0000  5.93899976272722E+0000  6.19885042274025E+0000
1.615  1.61500028500831E+0000  1.61500020000000E+0000  8.34902489155622E+0000
1.546  6.12823290066375E+0000  5.95399980000000E+0000  4.12193370077906E+0000
1.473  4.41900059507371E+0000  1.47300020000000E+0000  1.47300020316086E+0000
1.478  8.52199974344912E+0000  6.02199980000000E+0000  1.50585444819338E+0001
1.561  3.87075121495027E+0000  5.85224420842215E+0000  6.25427373703373E+0000
1.615  3.70023446067190E+0000  3.54055874506028E+0000  3.87093509634795E+0000
1.546  4.02260602268360E+0000  1.54600021355124E+0000  6.30193005285175E+0000
1.473  1.47300023279506E+0000  4.41900059565590E+0000  1.47300020000000E+0000
1.478  6.23215067281860E+0000  3.78141123059054E+0000  1.05919672432279E+0001
1.561  8.43899980000000E+0000  1.56100027164389E+0000  6.20064044944116E+0000
1.615  3.93273288766985E+0000  5.63296158881204E+0000  1.50329163464323E+0001
1.546  8.45399980000000E+0000  1.54623673106374E+0000  1.06151047650036E+0001
1.473  5.58104316695828E+0000  1.47300031101920E+0000  1.75361708847468E+0001
1.478  8.52199868105759E+0000  3.95080674127649E+0000  1.29494929370275E+0001
1.561  8.43899980000000E+0000  3.75091016241394E+0000  8.42576551049305E+0000
1.615  1.61500028534112E+0000  5.88499979163597E+0000  8.48978121501007E+0000
1.546  3.93448553595698E+0000  1.54600022917130E+0000  1.04954524037825E+0001
1.473  8.52699980000000E+0000  4.41895679143945E+0000  1.75361708698006E+0001
1.478  8.48149759991112E+0000  3.75853680776836E+0000  3.99651339752929E+0000
1.561  6.21240976688610E+0000  5.93899736358610E+0000  8.38727133996907E+0000
1.615  6.50094835994647E+0000  3.69538035643621E+0000  1.53209283716016E+0001
1.546  6.13841201549753E+0000  1.54600054760522E+0000  1.26641337105061E+0001
1.473  1.47300020697775E+0000  3.82331826622054E+0000  6.19521113238585E+0000
1.478  4.00358878866445E+0000  3.68747375145847E+0000  1.26294379957218E+0001
1.561  1.57997214876345E+0000  5.92221269081471E+0000  1.73756249428162E+0001
1.615  1.61500020000000E+0000  1.61500020000000E+0000  1.29381650743224E+0001
1.546  6.17044996782981E+0000  1.54600022147683E+0000  4.07769238739400E+0000
1.473  6.17404492898204E+0000  3.77093918619924E+0000  2.03710491081186E+0000
1.478  1.47800027332879E+0000  3.75595049565932E+0000  1.51662170086079E+0001
1.561  6.22545555955289E+0000  5.93899308249330E+0000  1.28565084382800E+0001
1.615  8.37374268198114E+0000  1.62631826429274E+0000  1.64664698798602E+0000
1.546  1.66813101551350E+0000  5.95399980000000E+0000  4.06530894116741E+0000
1.473  1.47300020860281E+0000  3.67668168763831E+0000  1.06435949687238E+0001
1.478  8.52199980000000E+0000  1.47800020003409E+0000  1.45691121423792E+0001
1.561  4.09988347977229E+0000  5.93767770788310E+0000  1.57101172147083E+0000
1.615  8.38499980000000E+0000  5.88499980000000E+0000  1.61500020519257E+0000
1.546  5.92840841299265E+0000  5.95399980000000E+0000  1.74631708939616E+0001
1.473  1.47300020000000E+0000  1.47300020000000E+0000  1.47300024487125E+0000
1.478  4.13731265751540E+0000  3.71879519345250E+0000  8.40203271970128E+0000
1.561  8.43679665551319E+0000  5.93899980000000E+0000  1.06526793888130E+0001
1.615  1.61500020000000E+0000  5.88499980000000E+0000  1.27974086951678E+0001
1.546  6.25007381683077E+0000  1.54600023255872E+0000  8.44642389976132E+0000
1.473  8.52699977983150E+0000  1.47300020000000E+0000  1.75201050878682E+0001
1.478  6.21997834693511E+0000  3.73061233595744E+0000  6.22372450410061E+0000
1.561  3.99831008073736E+0000  5.93899954637802E+0000  1.05883283523516E+0001
1.615  1.61659156876739E+0000  1.61500039622587E+0000  1.73941706791704E+0001
 1.90091710939616E+0001
