1.509  8.49099980000000E+0000  1.50900020000000E+0000  1.33747683422719E+0001
1.553  6.14427629281739E+0000  3.44699980000000E+0000  1.37107632577878E+0001
1.399  3.43372223871107E+0000  1.39900020000000E+0000  5.86522016462040E+0000
1.489  3.92984939640444E+0000  1.48900032557292E+0000  1.48901176692509E+0000
1.463  6.05572073512393E+0000  3.53699980000000E+0000  1.46300020000000E+0000
1.650  8.34999980000000E+0000  2.93931085373308E+0000  2.08735055134980E+0001
1.409  3.99847342520379E+0000  1.40902508056013E+0000  1.35846288296329E+0001
1.557  3.81893419995307E+0000  3.44297917769631E+0000  1.14333230516531E+0001
1.430  1.43000295481479E+0000  1.43000020484269E+0000  1.86713040014442E+0001
1.575  8.42499950086734E+0000  3.42499941445518E+0000  1.58513717843776E+0001
1.537  3.73132680578930E+0000  3.46299980000000E+0000  3.79847504627574E+0000
1.586  1.58600020000000E+0000  3.41399980000000E+0000  2.09375054386344E+0001
1.464  8.53599970072239E+0000  3.53599980000000E+0000  1.12003767146053E+0001
1.316  6.90456141884709E+0000  3.68109780285167E+0000  1.83244018660239E+0001
1.653  3.91508904873502E+0000  3.29997348463423E+0000  1.85147316299530E+0001
1.641  4.14340048514445E+0000  1.64100021640075E+0000  8.81130164175159E+0000
1.383  5.40576142213332E+0000  3.61699980000000E+0000  2.11405055391385E+0001
1.342  1.34200020000000E+0000  3.65799980000000E+0000  1.70244101037963E+0001
1.401  6.06892762729711E+0000  1.40100020000000E+0000  1.95548269513986E+0001
1.371  6.36848387289974E+0000  3.62899980000000E+0000  9.22240754262313E+0000
1.482  1.48200020488075E+0000  3.51799978248704E+0000  5.83719874503277E+0000
1.547  6.27638679949215E+0000  1.54700020000000E+0000  1.12648379423052E+0001
1.523  1.60124720341130E+0000  3.47699980000000E+0000  9.23256273943529E+0000
1.291  1.29100020000000E+0000  1.29100020000000E+0000  7.48792791091909E+0000
1.588  8.40411569497600E+0000  1.58800022104992E+0000  1.58800021076614E+0000
1.389  3.75652889362430E+0000  1.38900020000000E+0000  2.11345054664459E+0001
1.487  1.48700029524065E+0000  1.48700020000000E+0000  1.14879898701777E+0001
1.566  8.43399979049201E+0000  1.56600020000000E+0000  8.90046367830363E+0000
1.329  7.98133334150719E+0000  1.32900020000000E+0000  6.02736367211782E+0000
1.452  8.54799978975319E+0000  1.45200039566418E+0000  1.81437238530983E+0001
1.569  1.56900020000000E+0000  3.43099942855614E+0000  1.56900020000000E+0000
1.664  5.77327752539614E+0000  3.33599980000000E+0000  6.26080192353405E+0000
1.521  6.08962699920760E+0000  1.52100020000000E+0000  3.66273978698718E+0000
1.311  8.68899980000000E+0000  3.68899980000000E+0000  6.97563152060924E+0000
1.555  8.44499980000000E+0000  3.44499980000000E+0000  4.12341587251579E+0000
1.285  4.05202063315069E+0000  3.71499980000000E+0000  1.56094176602489E+0001
1.635  1.63500021140424E+0000  3.36499980000000E+0000  1.39775882209374E+0001
1.425  2.68741530407581E+0000  1.42500020000000E+0000  1.60971226886784E+0001
1.621  5.86495559228397E+0000  1.62111644682876E+0000  1.64898364196745E+0001
1.432  1.43201614761287E+0000  1.43200089991935E+0000  3.80311070443289E+0000
 2.25235057391385E+0001