1.890  2.27110059846646E+0000  4.92750643467534E+0000  2.06606315655847E+0001
1.512  8.48799945464220E+0000  5.11109984265069E+0000  5.85559384144760E+0000
2.419  2.59096945883161E+0000  2.57383100668963E+0000  2.68851387235838E+0001
1.850  8.14999980000000E+0000  1.85000020000000E+0000  2.27095956153071E+0001
1.943  5.29337031118926E+0000  4.99426965047392E+0000  2.37355715133843E+0001
1.890  1.89000020000000E+0000  5.22723644918016E+0000  1.12175317451079E+0001
1.512  4.99669813551088E+0000  8.48799980000000E+0000  5.60029452369272E+0000
2.419  7.58099980000000E+0000  2.53223424555655E+0000  2.68851387190450E+0001
1.850  8.14999980000000E+0000  8.14999980000000E+0000  1.88775933008955E+0001
1.943  1.94300023812534E+0000  1.94300020043064E+0000  1.82779933501271E+0001
1.890  1.89000024708097E+0000  8.10999980000000E+0000  1.86569096449903E+0001
1.512  5.01860237791282E+0000  1.51200020617028E+0000  5.97823804325442E+0000
2.419  2.41900020000000E+0000  7.58099980000000E+0000  2.77441614871465E+0000
1.850  1.85000021036758E+0000  1.85000020000000E+0000  2.27437140876259E+0001
1.943  8.05699980000000E+0000  5.05998849899879E+0000  1.55524400003688E+0001
1.890  8.10999980000000E+0000  8.10999980000000E+0000  2.26943953148526E+0001
1.512  1.51200022204189E+0000  4.98781454511775E+0000  2.39763119552527E+0001
2.419  2.41900020000000E+0000  2.41900020000000E+0000  3.13377398742017E+0000
1.850  5.00076793839116E+0000  5.15274183517655E+0000  5.16169979234766E+0000
1.943  1.94300020000000E+0000  1.94300020000000E+0000  1.43919929312898E+0001
1.890  1.96638057842730E+0000  8.07255638927930E+0000  1.37537292319791E+0001
1.512  1.51200020000000E+0000  8.48799980000000E+0000  1.03241420755100E+0001
2.419  7.58099980000000E+0000  7.51955055202265E+0000  1.18494471434626E+0001
1.850  5.54957531234326E+0000  1.85000020204230E+0000  1.55628127288076E+0001
1.943  5.10081889475418E+0000  8.05699980000000E+0000  1.60772643045602E+0001
1.890  7.95118025207698E+0000  8.10999972462275E+0000  7.36953966578921E+0000
1.512  5.07730661594400E+0000  1.51200021802620E+0000  2.40314731467470E+0001
2.419  7.58099980000000E+0000  2.41900020000000E+0000  3.13847848603687E+0000
1.850  1.85000020000000E+0000  5.24997008339712E+0000  1.62472970145655E+0001
1.943  1.94300020000000E+0000  5.93910520319130E+0000  7.26373245781942E+0000
1.890  4.65584250002232E+0000  5.01700314531844E+0000  1.37854728166266E+0001
1.512  4.99674531370335E+0000  8.48799972625214E+0000  2.40128677247169E+0001
2.419  2.53131449382874E+0000  7.42758707993369E+0000  2.68851387104155E+0001
1.850  4.54552268199243E+0000  8.14999980000000E+0000  8.91469393524151E+0000
1.943  5.12747343237394E+0000  4.72944011380391E+0000  1.80841611429839E+0001
1.890  5.14884241470322E+0000  4.45986507230034E+0000  8.83397434487474E+0000
1.512  8.48799978951092E+0000  8.48799979058058E+0000  1.55497473231645E+0001
2.419  7.43570865369806E+0000  7.36805256345019E+0000  2.68851387196767E+0001
1.850  5.00485785730454E+0000  7.47936525574387E+0000  2.07074386291763E+0001
1.943  8.05699980000000E+0000  1.94300020000000E+0000  1.84072854736344E+0001
1.890  1.89000020000000E+0000  8.10999978889774E+0000  2.26791294897406E+0001
1.512  8.48799969735623E+0000  5.10913835983725E+0000  8.87959380399400E+0000
2.419  7.58099980000000E+0000  7.58099980000000E+0000  2.78045412895117E+0000
1.850  7.85495466364289E+0000  4.94963758942314E+0000  2.07107961376810E+0001
1.943  8.05699980000000E+0000  1.94300024256865E+0000  7.56550224488181E+0000
1.890  4.95114532687469E+0000  1.89000020344480E+0000  2.06528926513433E+0001
1.512  5.00148020619153E+0000  4.89960712634349E+0000  1.51200020000000E+0000
2.419  7.58099980000000E+0000  2.50232797868587E+0000  1.18652260337238E+0001
1.850  3.46919273651046E+0000  1.85000020000000E+0000  1.09208347116700E+0001
1.943  1.94300020000000E+0000  2.05779762989030E+0000  7.45465402096893E+0000
 2.93041389235838E+0001
