1.302  1.30200020000000E+0000  3.69799980000000E+0000  8.74136211412705E+0000
1.501  6.07330517843510E+0000  1.50100020000000E+0000  1.01577712771282E+0001
1.478  8.52199980000000E+0000  3.52199980000000E+0000  1.47351071777468E+0001
1.536  3.06510742295381E+0000  3.46399980000000E+0000  6.52981443132399E+0000
1.613  8.38699980000000E+0000  1.61300020000000E+0000  1.61300023511463E+0000
1.560  6.20253808921761E+0000  1.56000020000000E+0000  1.47451483821505E+0001
1.537  1.53700020000000E+0000  3.46299980000000E+0000  1.25952540937988E+0001
1.548  3.73113411039852E+0000  3.45199980000000E+0000  1.02228792245771E+0001
1.391  6.26541512316734E+0000  3.60899887344322E+0000  1.72586120814681E+0001
1.645  1.64500024894952E+0000  3.29237760240893E+0000  1.64500023888153E+0000
1.463  3.77025331371731E+0000  1.46300020000000E+0000  1.24830725121684E+0001
1.611  8.38899979114206E+0000  3.38899980000000E+0000  4.42702643171165E+0000
1.604  8.38122324273160E+0000  1.60400021090491E+0000  1.23267496354632E+0001
1.572  8.42799974085902E+0000  3.42799978171924E+0000  9.72716961677401E+0000
1.341  3.94248484782667E+0000  1.34100020000000E+0000  8.26192668559848E+0000
1.302  6.45801609594732E+0000  3.69799980000000E+0000  2.26800064562872E+0000
1.501  5.92244551867256E+0000  3.49899980000000E+0000  1.23932231989065E+0001
1.478  1.47814468021692E+0000  1.47801269535459E+0000  1.48638856975647E+0001
1.536  1.75929532595406E+0000  3.46397742419278E+0000  1.71135958596746E+0001
1.613  1.61300057054719E+0000  1.61300036738744E+0000  4.43663707807638E+0000
1.560  5.89010302722086E+0000  3.43999980000000E+0000  7.79632237691299E+0000
1.537  3.75931765657652E+0000  3.46299980000000E+0000  1.47191146204581E+0001
1.548  4.17606967260498E+0000  1.54800020000000E+0000  1.71016178405224E+0001
1.391  3.84555751589059E+0000  3.60899980000000E+0000  3.71251004589667E+0000
1.645  5.70507797860278E+0000  1.65228265105075E+0000  5.12410476931402E+0000
1.463  1.47476801922532E+0000  1.46300020000000E+0000  1.03600514202388E+0001
1.611  8.38899979231880E+0000  1.61100020000000E+0000  7.11403295396020E+0000
1.604  4.55562096736050E+0000  1.60400020000000E+0000  1.60400020000000E+0000
1.572  8.40953566961511E+0000  1.57200023455142E+0000  1.70776177988594E+0001
1.341  1.35000009787434E+0000  1.34874161602707E+0000  7.48423003393435E+0000
 1.86496180405224E+0001