1.659  8.34099979922187E+0000  2.14698117824603E+0000  1.65900020033546E+0000
1.404  2.69349283363244E+0000  3.59599980000000E+0000  1.40244903698427E+0001
1.426  3.58034615755427E+0000  3.57399834114081E+0000  9.14868761159369E+0000
1.420  8.57999980000000E+0000  1.45876943699192E+0000  1.96147996546878E+0001
1.659  1.65900020000000E+0000  3.34099980000000E+0000  1.90199365455512E+0001
1.404  5.96849530094375E+0000  1.40400020000000E+0000  9.60458999808924E+0000
1.426  6.55545311101402E+0000  3.57398548598372E+0000  1.94540326496966E+0001
1.420  1.42000073859193E+0000  3.57999980000000E+0000  7.28947539810294E+0000
1.659  8.34099978203356E+0000  1.65900020000000E+0000  1.24296431982377E+0001
1.404  5.38043807173932E+0000  1.40400020000000E+0000  1.40400020000000E+0000
1.426  1.45794202658618E+0000  1.44877003113684E+0000  1.44907130493152E+0000
1.420  1.42000020000000E+0000  1.42000020000000E+0000  9.13338532974129E+0000
1.659  5.03829899690965E+0000  1.65900020000000E+0000  1.36613266580116E+0001
1.404  5.97053778129247E+0000  1.40400020000000E+0000  4.85918399478531E+0000
1.426  8.52364483696968E+0000  3.57399953381323E+0000  2.15180454673383E+0001
1.420  3.58077022697978E+0000  1.42000108927195E+0000  7.28857447328311E+0000
1.659  1.65900020000000E+0000  1.65900020000000E+0000  1.61598659361212E+0001
1.404  6.58655879199491E+0000  1.40400020000000E+0000  1.76152569007171E+0001
1.426  3.53018443605047E+0000  3.57399927448993E+0000  5.37981329286302E+0000
1.420  5.87675688584367E+0000  3.57941800199231E+0000  1.14043471118429E+0001
1.659  8.34099980000000E+0000  3.34099980000000E+0000  9.56957258326388E+0000
1.404  5.76570012040111E+0000  3.59599980000000E+0000  3.11618504244201E+0000
1.426  3.47497418146703E+0000  3.53360485821289E+0000  1.43385686427714E+0000
1.420  1.42000020000000E+0000  1.42000020000000E+0000  5.44556546640601E+0000
1.659  8.34099978137410E+0000  3.34099980000000E+0000  4.75471436792231E+0000
1.404  7.24475959520553E+0000  3.59599980000000E+0000  1.45339866402387E+0001
1.426  1.50765003999929E+0000  1.45698809846599E+0000  2.14888874214060E+0001
1.420  4.06110648534759E+0000  1.42000020000000E+0000  1.88789075319350E+0001
1.659  5.98634760414251E+0000  3.34099980000000E+0000  7.23189424033543E+0000
1.404  8.59599980000000E+0000  1.40400020000000E+0000  1.56538765819690E+0001
1.426  1.43164299628535E+0000  3.53022977289317E+0000  3.43747440825293E+0000
1.420  6.47788687599626E+0000  1.42000020000000E+0000  2.15240456164627E+0001
1.659  4.08354293928588E+0000  3.34099980000000E+0000  2.12850456185676E+0001
1.404  3.53463911206453E+0000  1.40400025117593E+0000  1.10050221836137E+0001
1.426  8.57399980000000E+0000  1.42600020000000E+0000  7.16214347669455E+0000
1.420  3.49293760086609E+0000  1.43368561815516E+0000  3.50434278556486E+0000
1.659  4.50059455772219E+0000  3.34099980000000E+0000  1.64844354675821E+0001
1.404  1.40400020000000E+0000  1.40400020000000E+0000  1.28340230140591E+0001
1.426  1.42600031962360E+0000  3.57399956656228E+0000  1.10175645077514E+0001
1.420  8.57999913106616E+0000  3.57999921098633E+0000  1.74538080265795E+0001
 2.29440458185676E+0001